MMMMMMMMMMMMMMAAAAAA
MMMMMBMMMAMMABBAAAAA
MMMMMAABCAMAACMAACAA
MMMMAABCCBAABAMAABBM
MMMAAAAMBBABBMMCMAMM
MMAAAAMBMMMMMBBCAAAM
MMABMAACBCBMMAACCBAM
MMBBMAAMAACBMBBAACBM
MMBBAACBMMMCMCMMBBBM
MMBAMAAACCBCCBCBBBMM
MMMCCBAMBBACMAACBMMM
MAABAACCCBABAACCCBAM
MBBAAAMCCBAAABABAABM
MABBAABBBBAABBABCBCM
MAAAAAACBBBAABABBBAM
MAAABBAAABAMAAAAABAM
MAAABBAABAAAABAAAABM
MAAAAAAAAAAAABBBBBMM
AAAAAAAAAAMMAAAAAAMM
AAAAAAAAAAAAAAAMMMMM