MMMMMMMMMMMMMMAAAAAA
MMMMMBMMMAMMAAAAAAAA
MMMMMAABAAAAAABAACAA
MMMMAAAAAAAAAABAABBM
MMMAAAAMAAABBBBCMAMM
MMAAAAMAMMMMBBBCAAAM
MMAAMAAACCCBBAACCBAM
MMAAMAAMBBCBCBBAACBM
MMAAAAAACCBCMCMMBBBM
MMAAMAAACCBCCBCBBBMM
MMMAAAACBBACMAACBMMM
MAAAAACCCBABAACCCBAM
MAAAAAMCCBAAABABAABM
MAAAAABBBBAABBABCBCM
MAAAAAACBBBAABABBBAM
MAAABBAAABAMAAAAABAM
MAAABBAABAAAABAAAABM
MAAAAAAAAAAAABBBBBMM
AAAAAAAAAAMMAAAAAAMM
AAAAAAAAAAAAAAAMMMMM