MMMMMMMMMMMMMMAAAAAA
MMMMMBMMMAMMAAAAAAAA
MMMMMAABMAAAAABAACAA
MMMMAAAAMAAMAABAABBM
MMMAAAAAAAACBBBCMAMM
MMAAAAMAMMMMBBBCAAAM
MMAAMAAACCCBBAACCBAM
MMAAMAAMBBCBCBBAACBM
MMAAAAAACCBCMCMMBBBM
MMAAMAAACCBCCBCBBBMM
MMMAAAACBBACMAACBMMM
MAAAAACCCBABAACCCBAM
MAAAAAMCCBAAABABAABM
MAAAAABBBBAABBABCBCM
MAAAAAACBBBAABABBBAM
MAAABBAAABAMAAAAABAM
MMMMBBMABMMAABAAAABM
MAAAAAMAAAAAABBBBBMM
AAAAAAMAAAMMAAAAAAMM
AAAAAAAAAAAAAAAMMMMM