MMAAAAAAAAAAAAAAAAAA
MMAMMBMMMMMMMAAAAAAA
MMAMMMMBMMMMMAAAAAAA
MMAMMMMMMMMMMMBCCBBM
MMAMMMMMMMMBBBBCCCMM
MMAMMMMMMMMMBBBCBBMM
MMAMMMMMCCCBBBBCCBMM
MMAMMMMMBBCBCBBBBCBM
MAAAMMMMCCBCCCBBBBBM
MMAAMMMMCCBCCBCBBBMM
MAAMMMMCBBCCBBBBBMMM
MAAMMMCCCBCBBBCCCBMM
MAAMMMMCCBBBBBCBBBBM
MAAMMMBBBBBBBBBBCBCM
MAAMMMMCBBBCCBBBBBMM
MAAMBBCCCBBCCCCCCBMM
MAMMBBBBBBBBBBMMMMBM
AAAAAABBBBBBBBBBBBMM
AAAAAAMMMMMMMMMMMMMM
AAAAAAMMMMMMMMMMMMMM