AAAAAABCMCBAABCMCBAA
AAAAAABCMCBAABCMCBAA
AAAAAABCMCBAABCMCBAA
AAAAAABCMCBAABCMCBAA
AAAAAABCMCBAABCMCBAA
AAAAAABCMCBAABCMCBAA
AAAAAABCMCBAABCMCBAA
AAAAAAAAAAAAABCMCBAA
AAAAAABCMCBAABCMCBAA
AAAAAABCMCBAAAAAAAAA
AAAAAABCMCBAABCMCBAA
AAAAAABCMCBAABCMCBAA
AAAAAABCMCBAABCMCBAA
AAAAAABCMCBAABCMCBAA
AAAAAABCMCBAABCMCBAA
AAAAAABCMCBAABCMCBAA
AAAAAABCMCBAABCMCBAA
AAAAAABCMCBAABCMCBAA
AAAAAABCMCBAABCMCBAA
AAAAAABCMCBAABCMCBAA