MMMMMMMAAAAMMMAAAAAA
MMMMMBMAMAMMAAAAAAAA
MMMMMAABMAAMAABAACAA
MMMMAAAAMAAMAABAABBM
MMMAAAAAMAAMAAACMAMM
MMAAMMMMMAAMAAACAAAM
MMAAMAAAMCAAAAACCBAM
AAAAMAAMBBCBCBBAACBM
AMAAAAAACCBCMCMMBBBM
AMAAMAAACCBCCBCBBBMM
AMMMMMMCBBACMAACBMMM
AAAAAAMCCBABAACCCBAM
MAAAAAMCCBAAABABAABM
MAAAAAMBBBAABBABCBCM
MAAAAAMCBBBAABABBBAM
MAACBAMAABAMAAAAABAM
MMMCBAMABMMAABAAAABM
MAAAAAMAAAAAABBBBBMM
AAAAAAMAAAMMAAAAAAMM
AAAAAAMMAAAAAAAMMMMM